12
000000000000
000000111000
001110111000
001110111000
001110000111
000000110111
000110110111
000110000000
000110000000
000000000000
110111101111
110111101111